 ______________________________________________________________________________________________________________________________________________________________________________________________ 
|                                                                                                                                                                                              |
|                                                                                                                                                                                              |
|                                                                                                                                                                                              |
|                                                                                                                                                                                              |
|                                                                                                                                                                                              |
|                                                                                                                                                                                              |
|                                                                                                                                                                                              |
|                                                                                                                                                                                              |
|                                                                                                                                                                                              |
|                                                                                                                                                                                              |
|                                                                                                                                                                                              |
|                                                                                                                                                                                              |
|                                                                                                                                                                                              |
|                                                                                                                                                                                              |
|                                                                                                                                                                                              |
|                                                                                                                                                                                              |
|                                                                                                                                                                                              |
|                                                                                                                                                                                              |
|                                                                                                                                                                                              |
|                                                                                                                                                                                              |
|                                                                                                                                                                                              |
|                                                                                                                                                                                              |
|                                                                                                                                                                                              |
|                                                                                                                                                                                              |
|                                                                                                                                                                                              |
|                                                                                                                                                                                              |
|                                                                                                                                                                                              |
|                                                                                                                                                                                              |
|                                                                                                                                                                                              |
|                                                                                                                                                                                              |
|                                                                                                                                                                                              |
|                                                                                                                                                                                              |
|                                                                                                                                                                                              |
|                                                                                                                                                                                              |
|                                                                                                                                                                                              |
|                                                                                                                                                                                              |
|                                                                                                                                                                                              |
|                                                                                                                                                                                              |
|                                                                                                                                                                                              |
|                                                                                                                                                                                              |
|                                                                                                                                                                                              |
|                                                                                                                                                                                              |
|                                                                                                                                                                                              |
|                                                                                                                                                                                              |
|                                                                                                                                                                                              |
|                                                                                                                                                                                              |
|                                                                                                                                                                                              |
|______________________________________________________________________________________________________________________________________________________________________________________________|