 ______________________________________________________________________________________________________________________________________________________________________________________________ 
|##############################################################################################################################################################################################|
|##############################################################################################################################################################################################|
|##############################################################################################################################################################################################|
|##############################################################################################################################################################################################|
|  !          ###########################################                                    ##################################################################################################|
|               #######################################                                                ########################################################################################|
|                 ###################################                                                               ###########################################################################|
|                  #################################                                                                           ################################################################|
|                   ##############################                                                                                 ############################################################|
|                    ###########################                                                                                     ##########################################################|
|                                                                                                                                     #########################################################|
|                                                                                                                                        ######################################################|
|                        %%%%%%%%%%%%%%%%%                                                                                                   ##################################################|
|                        %%%%%%%%%%%%%%%%%                                                                                                        #############################################|
|                        %%%%%%%%%%%%%%%%%                                                                                                             ########################################|
|                        %%%%%%%%%%%%%%%%%                                                               %%%%%%%%%%%%%%%%%%%%                               ###################################|
|                                                                            #######                     %%%%%%%%%%%%%%%%%%%%                                       %%%%%%%%%%%  ##############|
|                                                                          ############                  %%%%%%%%%%%%%%%%%%%%                                       %%%%%%%%%%%  ##############|
|                                                                          ############                  %%%%%%%%%%%%%%%%%%%%                                    ##############################|
|###################################                                       ############                  %%%%%%%%%%%%%%%%%%%%                                   ###############################|
|####################################                                      ############                  %%%%%%%%%%%%%%%%%%%%                                  ################################|
|####################################                                          ############              %%%%%%%%%%%%%%%%%%%%                               ###################################|
|#####################################                                          ############             %%%%%%%%%%%%%%%%%%%%                                ##################################|
|#####################################                                             ############                                                                ################################|
|######################################                                              ############                                                                 #############################|
|######################################                                               ############                                         ##########               ###########################|
|######################################                                               ###################                            ##############                 ###########################|
|######################################       %%%%%%%%%%%%%%%%%%%%               !  #######################                        ############                     ###########################|
|######################################       %%%%%%%%%%%%%%%%%%%%          ##############################    %%%%%%%%%       ###############                       ###########################|
|######################################       %%%%%%%%%%%%%%%%%%%%        #############################       %%%%%%%%%       ############                          ###########################|
|######################################       %%%%%%%%%%%%%%%%%%%%       ############################         %%%%%%%%%       ############                          ###########################|
|######################################       %%%%%%%%%%%%%%%%%%%%      ###########################                           ############                       ##############################|
|######################################       %%%%%%%%%%%%%%%%%%%%     ##########################                             ###########   %%%%%%%%%%        #################################|
|######################################       %%%%%%%%%%%%%%%%%%%%    ##########################                             ############   %%%%%%%%%%      ###################################|
|######################################       %%%%%%%%%%%%%%%%%%%%    ########################                               ############   %%%%%%%%%%     ####################################|
|######################################                               ########################                               ############   %%%% ! %%%    #####################################|
|######################################                               ########################                                ######################### #######################################|
|#####################################                                ########################                                       ##########################################################|
|####################################                                   ######################                                       ##########################################################|
|###################################                                   #######################    %%%%%%%%%%%%%%%%%%%%                     ####################################################|
|###################################                                  ########################    %%%%%%%%%%%%%%%%%%%%                       ##################################################|
|##################################                                 ##########################    %%%%%%%%%%%%%%%%%%%%                                   !  ###################################|
|############################## %%%%%%%%%%%%%%%%%%%%              ############################    %%%%%%%%%%%%%%%%%%%%                                      ###################################|
|###########################    %%%%%%%%%%%%%%%%%%%%             #############################    %%%%%%%%%%%%%%%%%%%%                                  #######################################|
|###########################    %%%%%%%%%%%%%%%%%%%%###########################################################################################################################################|
|###########################                        ###########################################################################################################################################|
|##############################################################################################################################################################################################|
|______________________________________________________________________________________________________________________________________________________________________________________________|